

S ./textures/sprite_1.xpm
F 77,0,254

R 1000 1000
EA ./textures/east.xpm
NO ./textures/north.xpm

WE ./textures/west.xpm

C 92,206,255

SO ./textures/south.xpm

        1111111111111111111111111
        1000000000110000000000001
        1011000001110W02222220001
        1001000000000002222220001
111111111011000001110000000000001
100000000011000001110111111111111
11110111111111011100000010001
11110111111111011101010010001
11000000110101011100000010001
10022000000000001100000000001
10022000000000001101010010001
11000111110101111101111000111
11110111 1110101 101111010001
11111111 1111111 111111111111
